1 3 692 694 694 
1 7 9149 5173 2199 9154 2559 3378 5172 
1 7 2322 9145 5130 173 987 327 1088 
1 3 1088 1846 5108 
1 4 1506 9146 9147 9148 
1 12 5252 4013 4105 1225 3557 125 5186 1584 9137 9138 2976 9139 
1 6 125 2256 4039 5108 9144 9141 
1 5 5252 4306 5301 4640 5260 
1 8 383 155 5263 1845 4175 1672 2145 5172 
1 5 2199 9136 9135 2342 2128 
1 9 1216 383 5260 5238 1506 1495 5189 3235 5185 
1 5 1495 875 220 684 9149 
1 6 9147 2322 5151 9129 9134 9126 
1 5 5138 1731 9128 9131 9130 
1 5 5138 9128 9129 9132 5185 
1 3 9148 2322 1563 
1 7 9149 5157 9153 9152 1549 1021 5138 
1 3 5189 1021 5138 
1 4 1731 5151 460 5130 
1 6 5185 9127 513 9131 5138 9128 
1 2 9131 9126 
1 3 9126 9133 9132 
1 2 513 9126 
1 3 9152 1549 5138 
1 2 155 1216 
1 13 2342 322 5100 4402 2596 5069 2689 3616 5079 5071 298 5102 1088 
1 2 9130 5185 
1 32 1216 4684 345 1958 497 2332 507 491 5405 3709 245 1557 1978 5293 989 1902 5329 2970 5317 1396 367 120 2811 944 5410 5412 5391 3425 1490 5348 5388 8192 
1 18 101 5931 4286 2809 3783 1047 4813 2480 6036 6012 3658 1398 4566 5939 4434 6000 3003 3948 
1 34 101 3248 297 3130 3267 4797 2316 5653 5619 5598 5577 3395 5546 769 5557 3598 5621 1458 3247 5664 2614 5666 1316 4258 1375 5727 5712 92 5728 932 5823 5855 4220 3948 
1 9 101 4816 4876 5822 731 3477 5719 5700 5664 
1 32 3948 2386 4682 433 3356 1692 2305 352 2230 6252 6269 1804 6225 659 3354 6265 2673 1896 6291 1350 6166 3331 6070 917 5967 823 5888 13 4696 5744 3352 3459 
1 4 99 4659 6557 4836 
1 5 99 6416 6367 2550 2673 
1 18 5744 3292 1633 3512 1372 3886 5642 5636 444 3555 5555 4363 2066 5531 4569 4205 4012 497 
1 39 5888 83 5988 1438 5964 332 4231 4804 6013 2130 5927 707 5866 1355 1121 5776 5748 3316 5786 3260 5898 3784 1454 6071 6111 3753 6226 2366 6220 2558 3217 6240 6256 486 6233 6204 858 2442 6166 
1 3 4231 6128 3217 
1 7 6013 3971 5989 54 5932 1229 5898 
1 4 9141 2036 5103 400 
1 11 400 1425 848 4020 2374 1546 5104 1770 5085 508 4690 
1 10 5103 3912 2931 5174 777 4818 2389 2074 4789 4232 
1 4 4519 244 5205 5174 
1 16 4519 2381 1792 5298 1484 5366 2712 2356 5445 5485 3454 2263 1093 4046 4755 5592 
1 4 5259 4869 638 4519 
1 4 5259 2906 5218 2389 
1 3 5205 1478 5259 
1 3 4869 1478 5218 
1 4 638 5205 646 777 
1 22 345 609 4884 454 1543 5475 5506 4674 2325 5597 4237 5643 5665 4368 1859 4795 5632 3729 489 4196 5499 4012 
1 3 1859 45 4706 
1 4 489 2441 5610 5643 
1 9 2066 5560 3165 5584 4790 1975 5620 5601 3729 
1 16 2325 2810 4344 557 5518 1010 4594 5420 3172 1682 1094 5466 4466 2182 2171 5445 
1 11 5684 3106 5678 4897 3665 2584 5568 3917 154 3712 3454 
1 12 6226 6213 4725 6257 23 6266 1431 4602 6243 6221 3181 3110 
1 5 3316 1068 5730 3006 1859 
1 17 3459 5709 822 4534 3009 5635 573 4484 5650 5605 1957 1136 3136 1637 5477 3819 5410 
1 6 5666 5641 4085 5603 3553 4414 
1 7 4414 311 5547 517 5456 134 1136 
1 13 944 20 1275 5494 1513 3185 1296 5559 5587 1402 3461 950 1633 
1 9 3584 6302 1428 4802 6308 2370 6315 6264 2305 
1 5 5298 3183 5280 9140 9139 
1 4 5186 30 5208 4519 
1 5 3512 2125 3801 3907 5866 
1 5 489 5544 4250 5451 4884 
1 3 3729 5595 2441 
