1 3 692 694 694 
1 9 9149 684 9150 5189 3235 9130 513 9126 9133 
1 8 9126 9133 9132 5151 9147 9148 2322 1563 
1 10 9126 513 9127 5185 3235 1506 5238 5260 383 1216 
1 7 9149 5173 2199 9154 2559 3378 5172 
1 7 2322 9145 5130 173 987 327 1088 
1 3 1088 1846 5108 
1 4 1506 9146 9147 9148 
1 5 5189 1495 875 220 684 
1 3 1495 222 5238 
1 2 1495 1506 
1 9 9126 9131 5138 1021 9152 9151 5 5157 9149 
