1 3 692 694 694 
1 7 9149 5173 2199 9154 2559 3378 5172 
1 7 2322 9145 5130 173 987 327 1088 
1 3 1088 1846 5108 
1 4 1506 9146 9147 9148 
1 9 1216 383 5260 5238 1506 1495 5189 3235 5185 
1 5 1495 875 220 684 9149 
1 6 9147 2322 5151 9129 9134 9126 
1 5 5138 1731 9128 9131 9130 
1 5 5138 9128 9129 9132 5185 
1 7 9149 5157 9153 9152 1549 1021 5138 
1 3 5189 1021 5138 
1 4 1731 5151 460 5130 
1 6 5185 9127 513 9131 5138 9128 
1 2 9131 9126 
1 3 9126 9133 9132 
1 2 513 9126 
1 3 9152 1549 5138 
1 13 2342 322 5100 4402 2596 5069 2689 3616 5079 5071 298 5102 1088 
1 2 9130 5185 
1 32 1216 4684 345 1958 497 2332 507 491 5405 3709 245 1557 1978 5293 989 1902 5329 2970 5317 1396 367 120 2811 944 5410 5412 5391 3425 1490 5348 5388 8192 
1 26 3948 3003 6000 4434 5939 4566 1398 3658 6012 6036 2480 4813 1047 3783 2809 4286 5931 101 1535 5959 25 1295 5847 5809 1977 3267 
1 34 101 3248 297 3130 3267 4797 2316 5653 5619 5598 5577 3395 5546 769 5557 3598 5621 1458 3247 5664 2614 5666 1316 4258 1375 5727 5712 92 5728 932 5823 5855 4220 3948 
1 9 101 4816 4876 5822 731 3477 5719 5700 5664 
1 32 3948 2386 4682 433 3356 1692 2305 352 2230 6252 6269 1804 6225 659 3354 6265 2673 1896 6291 1350 6166 3331 6070 917 5967 823 5888 13 4696 5744 3352 3459 
1 4 4836 6557 4659 99 
1 5 99 6416 6367 2550 2673 
1 18 5744 3292 1633 3512 1372 3886 5642 5636 444 3555 5555 4363 2066 5531 4569 4205 4012 497 
1 39 5888 83 5988 1438 5964 332 4231 4804 6013 2130 5927 707 5866 1355 1121 5776 5748 3316 5786 3260 5898 3784 1454 6071 6111 3753 6226 2366 6220 2558 3217 6240 6256 486 6233 6204 858 2442 6166 
1 3 4231 6128 3217 
1 7 6013 3971 5989 54 5932 1229 5898 
1 4 9141 2036 5103 400 
1 11 400 1425 848 4020 2374 1546 5104 1770 5085 508 4690 
1 10 5103 3912 2931 5174 777 4818 2389 2074 4789 4232 
1 4 4519 244 5205 5174 
1 16 4519 2381 1792 5298 1484 5366 2712 2356 5445 5485 3454 2263 1093 4046 4755 5592 
1 4 5259 4869 638 4519 
1 4 5259 2906 5218 2389 
1 3 5205 1478 5259 
1 3 4869 1478 5218 
1 4 638 5205 646 777 
1 22 345 609 4884 454 1543 5475 5506 4674 2325 5597 4237 5643 5665 4368 1859 4795 5632 3729 489 4196 5499 4012 
1 15 1859 45 4706 1663 5713 5690 5660 5676 4170 2817 3613 5661 4257 2913 3665 
1 4 489 2441 5610 5643 
1 9 2066 5560 3165 5584 4790 1975 5620 5601 3729 
1 16 2325 2810 4344 557 5518 1010 4594 5420 3172 1682 1094 5466 4466 2182 2171 5445 
1 15 3454 3712 154 3917 5568 2584 3665 4897 5678 3106 5684 5647 5607 5626 4046 
1 12 6226 6213 4725 6257 23 6266 1431 4602 6243 6221 3181 3110 
1 5 3316 1068 5730 3006 1859 
1 17 3459 5709 822 4534 3009 5635 573 4484 5650 5605 1957 1136 3136 1637 5477 3819 5410 
1 6 5666 5641 4085 5603 3553 4414 
1 7 4414 311 5547 517 5456 134 1136 
1 13 944 20 1275 5494 1513 3185 1296 5559 5587 1402 3461 950 1633 
1 9 3584 6302 1428 4802 6308 2370 6315 6264 2305 
1 5 5298 3183 5280 9140 9139 
1 4 5186 30 5208 4519 
1 5 3512 2125 3801 3907 5866 
1 5 489 5544 4250 5451 4884 
1 3 3729 5595 2441 
1 2 1506 1563 
1 4 1563 2021 4918 173 
1 2 1846 2256 
1 2 2128 2342 
1 7 5172 2145 1672 4175 5263 155 1216 
1 3 9141 9144 5108 
1 3 5252 4013 4105 
1 2 2256 5186 
1 3 1563 2322 9148 
1 3 5189 1911 220 
1 3 1563 3909 5238 
1 5 220 875 2985 222 5238 
1 3 1824 4167 1326 
1 3 1824 968 5092 
1 3 5092 676 626 
1 5 626 943 5200 1993 1233 
1 6 1233 1443 5257 5285 786 5329 
1 4 2199 9136 9135 2342 
1 5 5252 4306 5301 4640 5260 
1 11 6557 4836 2887 6643 6698 3116 6722 4782 3505 2865 1652 
1 24 1645 7074 4775 4375 1555 2695 7258 1961 4564 7179 177 838 2160 2620 7267 2090 2948 1608 7372 4890 3156 3946 4008 4353 
1 7 2776 2160 7179 177 4775 7074 1645 
1 2 2776 1645 
1 77 1608 4034 7446 7481 7526 771 7567 2408 1009 7584 2138 7572 7610 165 4451 7666 1071 1900 2761 3700 3830 7638 607 7613 4537 972 1471 2941 7452 7367 267 671 7298 4807 1173 2748 4407 1687 7089 3817 6989 6939 1520 6861 2597 2853 4450 6624 1248 4177 4913 6413 6432 12 6491 4113 6359 2983 6329 6279 6304 2215 6375 4922 6433 6496 4279 3465 2421 531 6692 6736 107 4508 6815 6852 6828 
1 2 4537 7613 
1 3 307 4340 4537 
1 3 7613 307 165 
1 3 7666 7638 829 
1 5 829 4327 7531 3448 2941 
1 3 4353 1750 771 
1 6 1961 7258 3605 3953 254 7372 
1 2 838 1645 
1 9 855 2779 7636 7641 171 80 436 3700 3830 
1 8 855 4910 359 7775 4130 7838 3010 594 
1 10 1919 2407 234 2091 248 7870 1741 4504 114 7815 
1 6 7815 4670 3525 1940 286 7838 
1 32 29 4923 2957 2963 8077 4135 3049 994 8238 3468 8236 8234 7991 106 3357 2757 2623 7974 1106 216 2173 2727 2300 3762 223 3205 7825 7786 1930 2568 466 4451 
1 4 29 743 4143 2623 
1 18 3357 7983 7971 3092 7944 3034 4677 639 2727 7856 833 2555 4316 2392 4619 4499 7605 7584 
1 18 1652 6789 2922 6864 6880 4278 1507 7013 3250 3457 7098 2851 113 4751 2328 7166 4671 1687 
1 56 3584 6354 6392 6379 3848 6476 6516 2852 61 2518 1077 6839 6876 2540 4874 889 3921 4556 7055 3484 1865 3703 6964 6961 6943 3455 6921 6918 1757 1700 6908 4102 1411 1621 1796 4439 7046 7076 7018 7005 3419 4457 3558 7107 7097 7113 7144 100 7177 2368 2331 2158 2364 7088 3399 1507 
1 3 1865 6930 2540 
1 38 2110 4008 3899 7620 970 4641 7523 2469 7489 7442 3320 7328 105 2523 2695 1555 7149 4375 7066 7025 3407 6976 7003 4700 7080 7090 7123 7151 2139 7249 7348 4458 2652 7477 7463 2556 7535 7567 
1 7 7249 7267 7327 7334 3953 7352 7328 
1 8 2691 4747 390 3869 4783 1553 693 4008 
1 2 2691 2555 
1 2 2110 7526 
1 14 7177 7204 912 1646 7332 4144 7440 3073 7536 7598 2666 4194 353 171 
1 11 3110 919 6234 1830 6258 2250 3196 3437 6369 3028 4113 
1 13 6279 431 4618 6160 4500 2537 4588 3860 3671 2898 5731 3072 5661 
1 15 3071 4050 690 1767 5125 2167 5127 4657 5124 732 733 5160 3198 5175 943 
1 2 2128 3071 
1 2 5172 1767 
1 5 9139 2976 9138 9137 1584 
1 2 1584 5186 
1 52 1708 5832 5879 3545 3947 6072 2471 4390 6244 314 6409 958 3519 2780 1855 6740 3046 6846 6888 1594 6889 4624 6936 6940 6910 73 4608 959 4577 6911 2901 4855 6950 3245 4759 7047 629 3193 6941 3405 4081 3685 3956 6816 6778 1723 6754 6718 6710 4291 6587 2763 
1 13 5483 5501 719 651 2714 2354 5309 1073 1152 4558 1799 811 618 
1 47 811 909 5250 5266 197 5320 4129 2972 1197 5447 5488 2013 3551 1076 1432 5624 4600 4411 3253 1577 284 4799 2432 5909 5921 5934 4835 3968 3148 6080 6123 4843 60 6284 3322 6296 6313 6289 3763 4864 67 6268 648 6247 1394 4262 6384 
1 30 888 5533 3121 2399 5429 5426 1298 4190 5455 1836 458 5427 1455 3891 5409 1981 5509 3918 5463 2043 5414 1424 32 834 5403 2365 3274 694 2114 5447 
1 33 1836 2135 4628 3528 4057 2484 4862 2191 3434 3509 5307 1815 3249 363 1397 2283 2927 3294 121 5244 1814 5226 5217 1112 4507 116 5187 5203 2616 5202 625 5155 1284 
1 20 625 2097 3064 2737 2281 5291 5316 1280 2270 2053 5418 3100 5370 748 3800 147 5353 5332 5318 2927 
1 13 1199 3802 8027 2656 8006 208 2129 3661 1444 3409 7893 652 7882 
1 18 7632 3624 2720 7719 3026 7780 3233 1982 7861 4743 7885 2543 7887 7894 2681 3189 449 3409 
1 24 2169 2378 2347 5658 3229 5734 5777 5820 1772 5872 1847 4182 4832 4562 3952 4660 6102 43 6200 3411 6301 533 2736 1903 
1 6 386 5903 5873 5839 2832 5872 
1 6 4410 2493 2740 2119 5638 5658 
1 31 6738 3489 585 4841 1019 6574 6533 4578 3863 614 2884 821 6680 2023 6744 6776 6826 6834 6856 4298 3210 6980 7028 4883 3162 22 3351 7232 3321 7350 4720 
1 29 6991 6965 6942 6875 2857 2855 1007 6835 915 2638 2628 3733 212 2546 3576 3127 7061 7102 7133 7138 7147 7176 3293 3048 4118 3780 7162 4367 3069 
1 5 6991 3554 4915 1852 251 
1 4 3322 3433 6428 6471 
1 5 1645 4700 7003 7031 4775 
1 6 2568 2792 256 3538 7737 2761 
1 13 6269 6389 3476 4814 6649 6697 899 6809 4698 295 6952 210 1796 
